  #  #  #  #  #  #  #  #  #  #  #  #  #  #  #
  #  S  #  .  .  .  .  .  #  .  #  .  .  .  #
  #  .  .  .  .  .  .  .  #  .  #  .  .  .  #
  #  .  .  .  .  #  .  .  .  .  .  #  .  .  #
  #  .  .  .  .  .  .  .  .  .  .  .  .  .  #
  #  .  .  .  #  .  .  .  .  .  .  .  #  .  #
  #  .  .  .  .  #  .  #  .  #  .  .  .  .  #
  #  .  .  .  .  .  .  #  .  #  .  #  .  .  #
  #  .  #  .  .  #  .  .  .  #  .  .  .  G  #
  #  .  .  .  .  .  .  .  .  .  .  .  #  .  #
  #  .  .  .  #  .  .  .  .  .  .  .  #  #  #
  #  .  .  .  .  .  #  .  .  .  .  .  .  .  #
  #  .  .  .  .  #  .  .  .  .  .  .  .  .  #
  #  .  .  .  #  .  .  .  .  .  .  .  .  #  #
  #  #  #  #  #  #  #  #  #  #  #  #  #  #  #
ID : 
