###############
#S#.....#.#...#
#.......#.#...#
#....#.....#..#
#.............#
#...#.......#.#
#....#.#.#....#
#......#.#.#..#
#.#..#...#...G#
#...........#.#
#...#.......###
#.....#.......#
#....#........#
#...#........##
###############
