  #  #  #  #  #  #  #  #  #  #  #  #  #  #  #  #
  #  G  .  .  #  .  #  .  .  .  .  .  .  .  #  #
  #  .  .  #  .  #  .  #  #  .  .  #  .  .  .  #
  #  .  .  .  .  .  #  .  .  .  .  #  .  .  .  #
  #  #  .  .  .  .  .  .  .  .  .  #  .  .  .  #
  #  .  .  .  .  .  .  .  .  .  .  .  .  .  .  #
  #  .  #  .  .  .  .  .  .  .  .  .  .  .  .  #
  #  .  .  .  #  .  .  .  .  .  .  #  .  .  .  #
  #  .  .  .  .  .  .  .  .  .  #  .  .  .  #  #
  #  .  .  .  .  .  .  #  .  .  .  .  .  #  .  #
  #  .  .  .  .  .  .  .  #  .  #  .  #  .  .  #
  #  .  .  .  .  .  .  .  .  .  .  .  .  .  #  #
  #  .  .  .  .  .  .  .  .  #  .  .  .  .  .  #
  #  .  .  #  .  .  .  .  .  .  .  .  .  .  .  #
  #  .  #  .  .  .  .  #  .  .  .  #  .  .  S  #
  #  #  #  #  #  #  #  #  #  #  #  #  #  #  #  #
