##############
#G....#......#
#........#...#
#........#...#
#.........#..#
##...........#
#........#...#
#............#
#......#..#..#
#..##...#....#
#....#.......#
#.....#.#...##
#...#.......S#
##############
