######################
#S..###..............#
##..#.....#..........#
#...#....#..........##
#......#......#......#
#........#...........#
###....##........#...#
#.....#.#...#.#...#..#
#...#......#...##....#
#..##...#..##.#.##...#
#...##.........###.G.#
#..........#...#...#.#
#...##....##.......###
###.#...#......#...#.#
#.............#...##.#
#.#.....#...#.#......#
######################
