  #  #  #  #  #  #  #  #  #  #  #  #  #  #  #  #
  #  G  #  #  .  .  .  .  #  .  .  .  #  .  .  #
  #  .  #  .  .  .  .  .  .  .  .  .  .  .  .  #
  #  .  .  .  .  .  .  .  .  .  .  .  .  .  #  #
  #  .  .  .  .  .  .  #  #  .  .  .  .  .  .  #
  #  #  .  .  #  .  .  .  .  .  .  #  .  .  .  #
  #  .  .  .  .  .  .  .  .  .  .  .  .  #  .  #
  #  #  .  .  .  .  .  .  .  .  .  .  .  .  .  #
  #  .  .  .  .  #  .  .  .  .  .  .  .  .  .  #
  #  .  .  .  .  .  .  .  #  .  .  #  #  #  .  #
  #  .  .  .  .  .  .  .  .  #  .  .  .  .  .  #
  #  .  .  .  .  .  .  .  .  .  .  .  #  .  .  #
  #  .  .  .  .  .  .  .  .  .  .  .  .  .  .  #
  #  .  .  .  .  .  .  .  #  .  .  .  .  .  #  #
  #  .  .  .  .  .  #  .  .  #  #  .  .  .  S  #
  #  #  #  #  #  #  #  #  #  #  #  #  #  #  #  #
